親字	variants_官字	variants_風字
美	麗	
類	属	属
秋	穐	穐
冠	帽	帽
助	救	救
翰	纂	纂
馬	瑪	瑪
位	順	順
百	佰	佰
金	欽	欽
虫	蟲	蟲
箱	函	函
定	決	決
震	顫振	振
哩	浬	浬
寝	寐	寐
猫	貓	貓
黒	玄	玄
席	座	座
従	从	从
来	耒	耒
反	叛	叛
酒	醇	醇
須	必	必
外	夘	夘
光	輝	輝
片	刻	刻
噫	吁	吁
能	可	可
琴	箏	箏
鼓	皷	皷